[
  {
    "results": [
      "94002",
      "94005",
      "94010",
      "94011",
      "94014",
      "94015",
      "94016",
      "94017",
      "94018",
      "94019",
      "94020",
      "94021",
      "94025",
      "94026",
      "94027",
      "94028",
      "94030",
      "94037",
      "94038",
      "94044",
      "94060",
      "94061",
      "94062",
      "94063",
      "94064",
      "94065",
      "94066",
      "94070",
      "94074",
      "94080",
      "94083",
      "94102",
      "94103",
      "94104",
      "94105",
      "94107",
      "94108",
      "94109",
      "94110",
      "94111",
      "94112",
      "94114",
      "94115",
      "94116",
      "94117",
      "94118",
      "94119",
      "94120",
      "94121",
      "94122",
      "94123",
      "94124",
      "94125",
      "94126",
      "94127",
      "94128",
      "94129",
      "94130",
      "94131",
      "94132",
      "94133",
      "94134",
      "94137",
      "94139",
      "94140",
      "94141",
      "94142",
      "94143",
      "94144",
      "94145",
      "94146",
      "94147",
      "94151",
      "94158",
      "94159",
      "94160",
      "94161",
      "94163",
      "94164",
      "94172",
      "94177",
      "94188",
      "94401",
      "94402",
      "94403",
      "94404",
      "94497",
      "94501",
      "94502",
      "94505",
      "94506",
      "94507",
      "94509",
      "94511",
      "94513",
      "94514",
      "94516",
      "94517",
      "94518",
      "94519",
      "94520",
      "94521",
      "94522",
      "94523",
      "94524",
      "94525",
      "94526",
      "94527",
      "94528",
      "94529",
      "94530",
      "94531",
      "94536",
      "94537",
      "94538",
      "94539",
      "94540",
      "94541",
      "94542",
      "94543",
      "94544",
      "94545",
      "94546",
      "94547",
      "94548",
      "94549",
      "94550",
      "94551",
      "94552",
      "94553",
      "94555",
      "94556",
      "94557",
      "94560",
      "94561",
      "94563",
      "94564",
      "94565",
      "94566",
      "94568",
      "94569",
      "94570",
      "94572",
      "94575",
      "94577",
      "94578",
      "94579",
      "94580",
      "94582",
      "94583",
      "94586",
      "94587",
      "94588",
      "94595",
      "94596",
      "94597",
      "94598",
      "94601",
      "94602",
      "94603",
      "94604",
      "94605",
      "94606",
      "94607",
      "94608",
      "94609",
      "94610",
      "94611",
      "94612",
      "94613",
      "94614",
      "94615",
      "94617",
      "94618",
      "94619",
      "94620",
      "94621",
      "94622",
      "94623",
      "94624",
      "94649",
      "94659",
      "94660",
      "94661",
      "94662",
      "94666",
      "94701",
      "94702",
      "94703",
      "94704",
      "94705",
      "94706",
      "94707",
      "94708",
      "94709",
      "94710",
      "94712",
      "94720",
      "94801",
      "94802",
      "94803",
      "94804",
      "94805",
      "94806",
      "94807",
      "94808",
      "94820",
      "94850",
      "94901",
      "94903",
      "94904",
      "94912",
      "94913",
      "94914",
      "94915",
      "94920",
      "94924",
      "94925",
      "94929",
      "94930",
      "94933",
      "94937",
      "94938",
      "94939",
      "94940",
      "94941",
      "94942",
      "94945",
      "94946",
      "94947",
      "94948",
      "94949",
      "94950",
      "94956",
      "94957",
      "94960",
      "94963",
      "94964",
      "94965",
      "94966",
      "94970",
      "94971",
      "94973",
      "94974",
      "94976",
      "94977",
      "94978",
      "94979",
      "94998"
    ]
  }
]
